18 13
32 32
2 2 2 2 2 2 2 2 2 2 2 2 2 2 2 2 2 2
2 0 0 0 0 0 0 0 0 0 0 2 2 0 0 0 0 2
2 0 0 0 0 0 0 0 0 0 0 2 2 0 0 0 0 2
2 0 0 0 0 0 0 0 0 0 0 2 2 0 0 0 0 2
2 2 2 0 0 0 0 0 0 0 0 2 2 2 2 0 0 2
2 0 0 0 0 0 0 0 0 0 0 0 0 0 0 0 0 2
2 0 0 0 0 0 2 2 0 0 0 0 0 0 0 0 0 2
2 0 0 0 0 0 0 0 0 0 0 0 0 0 0 2 2 2
2 2 2 0 0 0 0 0 0 0 0 2 2 0 0 0 0 2
2 0 0 0 0 0 0 0 0 0 0 0 0 0 0 0 0 2
2 0 0 0 0 0 0 0 0 0 0 0 0 0 0 0 0 2
2 2 2 2 2 2 2 0 0 0 0 0 0 0 0 0 0 2
2 2 2 2 2 2 2 2 2 2 2 2 2 2 2 2 2 2